   #####
####   #
#  #$  ####
# $$      #
#@  #$ $# #
### #   # #
 #  ##### #
 #  ..... #
 ##########